19 19 19 19 19 19 19 19 19 19 19 19 19 19 19 19 19 19 19 19 19 19 19 19 19 19 19 19 19 19 19 19 19 19 19 19 19 19 19 19
19 20 20 20 20 20 20 20 20 4917 20 20 20 20 20 20 20 20 20 5017 17 20 20 20 20 20 20 20 20 20 4917 20 20 20 20 20 20 20 20 19
19 20 20 20 20 20 20 20 20 17 20 20 20 20 20 20 20 20 20 17 17 20 20 20 20 20 20 20 20 20 17 20 20 20 20 20 20 20 20 19
19 20 20 20 20 20 20 20 20 17 20 20 20 20 20 20 20 20 20 17 17 20 20 20 20 20 20 20 20 20 17 20 20 20 20 20 20 20 20 19
19 20 20 20 20 20 20 20 20 17 20 20 20 20 20 20 20 20 20 17 17 20 20 20 20 20 20 20 20 20 17 20 20 20 20 20 20 20 20 19
19 20 20 20 20 20 20 20 20 17 20 20 20 20 20 20 20 20 20 17 17 20 20 20 20 20 20 20 20 20 17 20 20 20 20 20 20 20 20 19
19 20 20 20 20 20 20 20 20 17 20 20 20 20 20 20 20 20 20 17 17 20 20 20 20 20 20 20 20 20 17 20 20 20 20 20 20 20 20 19
19 20 20 20 20 20 20 20 20 17 20 20 20 20 20 20 20 20 20 17 17 20 20 20 20 20 20 20 20 20 17 20 20 20 20 20 20 20 20 19
19 20 20 20 20 20 20 20 20 17 20 20 20 20 20 20 20 20 20 17 17 20 20 20 20 20 20 20 20 20 17 20 20 20 20 20 20 20 20 19
19 20 20 20 20 20 20 20 20 17 20 20 20 20 20 20 20 20 20 17 17 20 20 20 20 20 20 20 20 20 17 20 20 20 20 20 20 20 20 19
19 20 20 20 20 20 20 20 20 17 20 20 20 20 20 20 20 20 20 17 17 20 20 20 20 20 20 20 20 20 17 20 20 20 20 20 20 20 20 19
19 20 20 20 20 20 20 20 20 17 20 20 20 20 20 20 20 20 20 17 17 20 20 20 20 20 20 20 20 20 17 20 20 20 20 20 20 20 20 19
19 20 20 20 20 20 20 20 20 17 20 20 20 20 20 20 20 20 20 17 17 20 20 20 20 20 20 20 20 20 17 20 20 20 20 20 20 20 20 19
19 20 20 20 20 20 20 20 20 17 20 20 20 20 20 20 20 20 20 17 17 20 20 20 20 20 20 20 20 20 17 20 20 20 20 20 20 20 20 19
19 20 20 20 20 20 20 20 20 17 20 20 20 20 20 20 20 20 20 17 17 20 20 20 20 20 20 20 20 20 17 20 20 20 20 20 20 20 20 19
19 20 20 20 20 20 20 20 20 17 20 20 20 20 20 20 20 20 20 17 17 20 20 20 20 20 20 20 20 20 17 20 20 20 20 20 20 20 20 19
19 20 20 20 20 20 20 20 20 17 20 20 20 20 20 20 20 20 20 17 17 20 20 20 20 20 20 20 20 20 17 20 20 20 20 20 20 20 20 19
19 20 20 20 20 20 20 20 20 17 20 20 20 20 20 20 20 20 20 17 17 20 20 20 20 20 20 20 20 20 17 20 20 20 20 20 20 20 20 19
19 20 20 20 20 20 20 20 20 17 20 20 20 20 20 20 20 20 20 17 17 20 20 20 20 20 20 20 20 20 17 20 20 20 20 20 20 20 20 19
19 20 20 20 20 20 20 20 20 17 20 20 20 20 20 20 20 20 20 17 17 20 20 20 20 20 20 20 20 20 17 20 20 20 20 20 20 20 20 19
19 20 20 20 20 20 20 20 20 17 20 20 20 20 20 20 20 20 20 17 17 20 20 20 20 20 20 20 20 20 17 20 20 20 20 20 20 20 20 19
19 20 20 20 20 20 20 20 20 17 20 20 20 20 20 20 20 20 20 17 17 20 20 20 20 20 20 20 20 20 17 20 20 20 20 20 20 20 20 19
19 20 20 20 20 20 20 20 20 17 20 20 20 20 20 20 20 20 20 17 17 20 20 20 20 20 20 20 20 20 17 20 20 20 20 20 20 20 20 19
19 20 20 20 20 20 20 20 20 17 20 20 20 20 20 20 20 20 20 17 17 20 20 20 20 20 20 20 20 20 17 20 20 20 20 20 20 20 20 19
19 20 20 20 20 20 20 20 20 17 20 20 20 20 20 20 20 20 20 17 17 20 20 20 20 20 20 20 20 20 17 20 20 20 20 20 20 20 20 19
19 20 20 20 20 20 20 20 20 17 20 20 20 20 20 20 20 20 20 17 17 20 20 20 20 20 20 20 20 20 17 20 20 20 20 20 20 20 20 19
19 20 20 20 20 20 20 20 20 17 20 20 20 20 20 20 20 20 20 17 17 20 20 20 20 20 20 20 20 20 17 20 20 20 20 20 20 20 20 19
19 20 20 20 20 20 20 20 20 17 20 20 20 20 20 20 20 20 20 17 17 20 20 20 20 20 20 20 20 20 17 20 20 20 20 20 20 20 20 19
19 20 20 20 20 20 20 20 20 17 20 20 20 20 20 20 20 20 20 17 17 20 20 20 20 20 20 20 20 20 17 20 20 20 20 20 20 20 20 19
19 19 19 19 19 19 19 19 19 19 19 19 19 19 19 19 19 19 19 19 19 19 19 19 19 19 19 19 19 19 19 19 19 19 19 19 19 19 19 19
19 20 20 20 20 20 20 20 20 17 20 20 20 20 20 20 20 20 20 17 17 20 20 20 20 20 20 20 20 20 17 20 20 20 20 20 20 20 20 19
19 20 20 20 20 20 20 20 20 17 20 20 20 20 20 20 20 20 20 17 17 20 20 20 20 20 20 20 20 20 17 20 20 20 20 20 20 20 20 19
19 20 20 20 20 20 20 20 20 17 20 20 20 20 20 20 20 20 20 17 17 20 20 20 20 20 20 20 20 20 17 20 20 20 20 20 20 20 20 19
19 20 20 20 20 20 20 20 20 17 20 20 20 20 20 20 20 20 20 17 17 20 20 20 20 20 20 20 20 20 17 20 20 20 20 20 20 20 20 19
19 20 20 20 20 20 20 20 20 17 20 20 20 20 20 20 20 20 20 17 17 20 20 20 20 20 20 20 20 20 17 20 20 20 20 20 20 20 20 19
19 20 20 20 20 20 20 20 20 17 20 20 20 20 20 20 20 20 20 17 17 20 20 20 20 20 20 20 20 20 17 20 20 20 20 20 20 20 20 19
19 20 20 20 20 20 20 20 20 17 20 20 20 20 20 20 20 20 20 17 17 20 20 20 20 20 20 20 20 20 17 20 20 20 20 20 20 20 20 19
19 20 20 20 20 20 20 20 20 17 20 20 20 20 20 20 20 20 20 17 17 20 20 20 20 20 20 20 20 20 17 20 20 20 20 20 20 20 20 19
19 20 20 20 20 20 20 20 20 17 20 20 20 20 20 20 20 20 20 17 17 20 20 20 20 20 20 20 20 20 17 20 20 20 20 20 20 20 20 19
19 19 19 19 19 19 19 19 19 19 19 19 19 19 19 19 19 19 19 19 19 19 19 19 19 19 19 19 19 19 19 19 19 19 19 19 19 19 19 19